1,2,2,2,2,2,2,2,2,2,2,2,2,2,2,2,2,2,2,2,2,2,2,2,2,2,2,2,2,2,2,2,2,2,2,2,2,2,2,2,2,2,2,2,2,2,2,2,2,2,2,2,2,2,2,2,2,2,2,2,2,2,b,b,b,b,b,b,b,b,2,2,2,2,2,2,2,2,2,2
1,2,2,2,2,2,2,2,2,2,2,2,2,2,2,2,2,2,2,2,2,2,2,2,2,2,p,2,2,2,2,2,2,2,2,p,p,2,p,p,p,p,p,2,2,2,2,2,2,2,2,2,2,2,2,2,2,2,2,2,2,2,b,b,b,b,b,b,b,b,2,2,2,2,2,2,2,2,2,2
1,2,2,2,2,2,2,2,2,2,2,2,2,2,2,2,2,2,p,2,2,2,p,p,2,p,2,2,2,2,2,2,2,2,2,l,l,2,2,2,2,2,p,2,2,2,p,2,2,p,2,2,p,p,2,2,2,2,2,2,2,2,b,b,b,b,b,b,b,b,2,2,2,2,2,2,2,2,2,2
1,2,2,2,2,2,2,2,2,2,2,2,p,2,2,p,p,p,d,2,2,2,2,2,2,2,2,2,p,p,2,2,2,2,2,2,2,2,p,p,p,p,p,2,2,2,p,p,p,p,2,2,p,p,2,2,2,2,2,2,2,2,b,b,b,b,b,b,b,b,2,2,2,2,2,2,2,2,2,2
1,2,2,2,2,2,2,2,2,2,2,p,p,p,2,2,2,2,p,p,2,2,2,2,p,2,2,2,p,p,p,2,2,2,p,2,2,2,2,2,2,2,2,2,p,2,2,p,p,2,2,p,2,2,2,2,,p,p,2,2,2,b,b,b,b,b,b,b,b,2,2,2,2,2,2,2,2,2,2
1,2,2,2,2,2,2,2,2,2,p,p,p,p,p,2,d,2,2,2,2,p,p,p,p,l,l,l,p,p,p,p,2,p,p,2,2,,p,p,p,p,p,p,p,p,l,p,p,2,2,p,2,2,2,p,p,p,p,2,2,2,b,b,b,b,b,b,b,b,2,2,2,2,2,2,2,2,2,2
1,1,1,1,1,1,1,1,1,1,1,1,1,1,1,1,1,1,1,1,1,1,1,1,1,1,1,1,1,1,1,1,1,1,1,1,1,1,1,1,1,1,1,1,1,1,1,1,1,1,1,1,1,1,1,1,1,1,1,1,1,1,1,1,1,1,1,1,1,1,1,1,1,1,1,1,1,1,1,1